11111111111111111111111
1C00000000000100C000001
10000000000000000000001
1101110000111100C000001
10000000001111000000001
11111111000111000000001
1C000000000001000000001
10000000000001000000E01
11011100001111000000001
10000000000C000000C00P1
11111111111111111111111