1111111111111111111111111111111111111
1000000000E00000C000000000000000000P1
1111111111111111111111111111111111111